10-ab
----------
----a-----
----------
----------
----------
---a------
-a--------
----------
----------
-aa-------